NO ./textures/bluestone.png
SO ./textures/colorstone.png
WE ./textures/eagle.png
EA ./textures/greystone.png
F 0,0,0
C 255,255,255
                          
       1111111111111111111
       1000000000000000001
       1000000000000000001
       1000000000001111101
 1111111000000000011111111
 1111111000000000011111111
 1111111000000000001111101
 1111111000000000000000001
 1111111000000000000000001
 1111111000000000000000001
 1111111000000000000000001
11111000000000000000001
 1111111000000000000000001
 1111111000000000000000001
 1111111000000000000000001
 1111111000000000000000001
 1111111000000000000000001
 1111111000000000000000001
 1111111000000000000000001
 1111111000000000000000001
 1111111000000000000000001
 1111111000000000000000001
 1111111000000000000000001
 1111111000000000000000001
 1111111000000000000000001
 1111111000000000000000001
 1111111000000000000000001
 1111111000000000000000001
 1111111000000000000000001
 1111111000000000000000001
 1111111000000000000000001
 1111111000000000000000001
 1111111000000000000000001
 1111111000000000000000001
 1111111000000000000000001
 1111111000000000000000001
 1111111000000000000000001
 1111111000000000000000001
 1111111000000000000000001
 1111111000000000000000001
 1111111000000000000000001
 1111111000000000000000001
 1111111000000000000000001
 1111111000000000000000001
 1111111000000000000000001
 1111111000000000000000001
 1111111000000000000000001
 1111111000000000000000001
 1111111000000000000000001
 1111111000000000000000001
 1111111000000000000000001
 1111111000000000000000001
 1111111000000000000000001
 1111111000000000000000001
 1111111000000000000000001
 1111111000000000000000001
 1111111000000000000000001
 1111111000000000000000001
 1111111000000000000000001
 1111111000000000000000001
 1111111000000000000000001
 1111111000000000000000001
 1111111000000000000000001
 1111111000000000000000001
 1111111000000000000000001
 1111111000000000000000001
 1111111000000000000000001
 1111111000000000000000001
 1111111000000000000000001
 1111111000000000000000001
 1111111000000000000000001
 1111111000000000000000001
 1111111000000000000000001
       1000000000000000001
       1000001111111000001
       1000001     1000001
       1000001     1000001
       1000001     1000001
       1111111     1111111
 
